8 . O #
.......O
.O......
........
....O...
........
........
........
..O.....
